111111
1PCCC1
1BBBC1
1CCCC1
1CBBB1
1CCCE1
111111