1111111111111
1P0000100C001
1000001011101
1110101010001
1C0010001E001
1111111111111
