111111111111111111111111
1P0000000000111111111111
10000C000000111111111111
100010000000111111111111
10000000000E111111111111
111111111111111111111111